1111111111111111111111
100000000001C001000001
100EP00001001001100001
1000000000000000000001
1111111111111111111111
