111111111111111111111111111111111
100000000000000000000000000000001
100000000000000000000000000000001
100000000000000000000000000000001
1P0000011101110100011101010000001
100000010001010100010101010000001
100C0001110111010001110111000C001
100000000101010100010101010000001
100000011101010111010101010000001
100000000000000000000000C00000001
1000000000C00000000C0000000000E01
100000000000000000000000000000001
111111111111111111111111111111111